
SO ./img/so.xpm

WE ./img/we.xpm


NO               ./img/no.xpm            
EA ./img/ea.xpm


C 33,33,222

F 250,40,1

11111111111111111111111111111
11110111111111011100000010001
11110111111111011101010010001
11000000110101011100000010001
10000000000000001100000010001
1000000000000000110101000000111111
110000011101010111100000000000000111
11110111 1110101 10000000000000001111
11111111 1111111 10000000000000111
11111111 1111111 10000000S0000011
11111111 1111111 1000000010000011
11111111 1111111 1000000000000011
11111111 1111111 1000000000000011
11111111 1111111 111111111111111

