NO ./img/simple_answers.xpm

R 640 420

SO ./img/nano.xpm

WE ./img/vim.xpm

EA ./img/emacs.xpm

S ./mlx/test/open.xpm

C 33,33,222

F 122,40,12


        1111111111111111111111111
        1000000000110000000000001
        1011000001110000002000001
        1001000000000000000000001
111111111011000001110000000000001
100000000011000001110111111111111
11110111111111011100000010001
11110111111111011101010010001
11000000110101011100000010001
10002000000000001100000010001
1000000000000000110101000000111111
110000011101010111100000000000000111
11110111 1110101 10000000000000001111
11111111 1111111 11000000000000011
11111111 1111111 110000000S0000011
11111111 1111111 11000000000000011
11111111 1111111 11000000000000011
11111111 1111111 11000000000000011
11111111 1111111 11111111111111111
