
SO ./img/so.xpm
WE ./img/we.xpm

NO ./img/no.xpm            
EA ./img/ea.xpm


C 2,0,0

F 250,40,1


        1111111111111111111111111
        1111111111111111111111111
        1001000000000000000000001
111111111011000001110000000000001
100000000011000001110111111111111
1111011111111101110000001000001
1111011111111101110101001000001
1100000001010101110000001000001
1000000000000000001100000010001
1000000000000000110101000000111111
11000001110101011110000000000000011
11110111 1110101 100000000000000011
11111111 1111111 10000000000000111
11111111 1111111 10000000S010001
11111111 1111111 100000000000001
11111111 1111111 100000000000001
11111111 1111111 100000000000001
