
SO ./img/so.xpm
WE ./img/west.xpm

NO ./img/north.xpm            

EA ./img/ea.xpm


F 155,25,45

C 1,11,121





        1111111111111111111111
        1111111111111111111111
        1001000000000000000001
111111111011000001110000000001
100000000011000001110111111111
111101111111110111000000100001
111101111111110111010100100001
110000000101010111000000100001
100000000000000000110000001001
1000000000000000110101000000111
11000001110101011110000000000111
10000001 1000001 100000000000111
10000001 1000001 100E0000000011
10000001 100000111000000000101
10000001 100000101000000W00001
10000001 100000111000000100001
10000001 1000001 1000000000001
111111111111111111111111111111
